1 2 3 4 5 6 7 0 3 2 1 4 7 6 5 0  
2 4 0 1 7 5 6 3 4 1 2 7 0 6 5 3  
3 0 7 5 1 2 6 4 7 0 3 5 1 2 4 6  
4 6 1 2 0 7 3 5 6 4 0 7 2 1 3 0  
5 1 2 6 7 0 4 3 2 7 1 0 6 5 4 3  
6 7 5 0 4 3 1 2 5 6 7 0 3 4 2 1  
7 0 6 3 2 1 5 4 0 7 3 6 5 2 1 4  
0 3 4 7 6 2 1 5 3 4 7 0 2 6 1 5  
4 1 0 5 3 7 6 2 1 5 4 7 3 6 0 2  
3 5 7 6 0 2 1 4 5 3 6 1 7 0 4 2  
2 0 6 1 5 3 7 4 6 2 1 5 4 3 7 0  
1 7 3 5 4 6 0 2 7 1 3 6 0 5 2 4 